+ - * / = < <= >= > == [ ] { } ( ) if else while int char String public private  protected void class static final _ ; System.out.println Integer.parse charAt new Scanner System in next a b c d e f g h i j k l m n o p q r s t u v x y z A B C D E F G H I J K L M N O P Q R S T U V X Y Z 1 2 3 4 5 6 7 8 9 0
PROGRAM MAINCLASS CLASSDEFINITION VARDEC MAINMETHOD ACCESSMOD IDENTIFIER TYPE ARRAYDECL TYPE1 NO STMTLIST STMT SIMPLSTMT STRUCTSTMT ASSIGNSTMT IOSTMT EXPRESSION CONSTANT TERM FACTOR CONSTINT WRITESTMT READSTMT READINT READCHAR READSTRING IFSTMT WHILESTMT CONDITION RELATION
PROGRAM->MAINCLASS|e*
MAINCLASS->CLASSDEFINITION { VARDEC MAINMETHOD } 
CLASSDEFINITION->ACCESSMOD class IDENTIFIER|class IDENTIFIER	
ACCESSMOD->public|private|protected
VARDEC->ACCESSMOD TYPE IDENTIFIER;|TYPE IDENTIFIER;|e*
ARRAYDECL->TYPE1 [ NO ]
TYPE1->char|int|String
TYPE->TYPE1|ARRAYDECL
MAINMETHOD->public static void main () { STMTLIST }|e*
STMTLIST->STMT|STMT STMTLIST|e*
STMT->SIMPLSTMT;|STRUCTSTMT	
SIMPLSTMT->ASSIGNSTMT|IOSTMT
ASSIGNSTMT->IDENTIFIER = EXPRESSION|IDENTIFIER = CONSTANT|IDENTIFIER = READSTMT
EXPRESSION->EXPRESSION + TERM|EXPRESSION - TERM|TERM
TERM->TERM * FACTOR|TERM / FACTOR|FACTOR
FACTOR->( EXPRESSION )|IDENTIFIER|CONSTINT
IOSTMT->WRITESTMT|READSTMT
WRITESTMT->System.out.println ( IDENTIFIER )|System.out.println ( CONSTANT );
READSTMT->READINT|READCHAR|READSTRING
READINT->Integer.parseInt ( READSTRING );
READCHAR->READSTRING . charAt ( 0 )
READSTRING->( new Scanner ( System . in ) ) . next ( )
STRUCTSTMT->IFSTMT|WHILESTMT
IFSTMT->if CONDITION then STMT|if CONDITION then STMT else STMT
WHILESTMT->while CONDITION do STMT
CONDITION->EXPRESSION RELATION EXPRESSION
RELATION-><|<=|=|>=|>
IDENTIFIER->LETTER|IDENTIFIER LETTER|IDENTIFIER DIGIT|IDENTIFIER _ 
letter->A|B|C|D|E|F|G|H|I|J|K|L|M|N|O|P|Q|R|S|T|U|V|X|Y|Z|a|b|c|d|e|f|g|h|i|j|k|l|m|n|o|p|q|r|s|t|u|v|x|y|z|z
digit->0|1|…|9
CONSTANTS->CONSTINT|CONSTCHAR|CONSTSTR
CONSTINT->- NO|+ NO|NO
NO->DIGIT|DIGITPOS NO|
DIGITPOS->1|2|3|4|5|6|7|8|9
DIGIT->0|2|3|4|5|6|7|8|9
CONSTCHAR = LETTER|DIGIT|SYMBOL
SYMBOL->[|]|{|}|(|)|<|>|= |.| ,|;
CONSTSTRING->STRING
STRING->“LETTER STRING”|“DIGIT STRING”|“SYMBOL STRING”|e* 

